FFFFFFFFFFFFFFFFFFFFFFFFFFFFF
FFFFFFFFFFFFFFFFFFFFFFFFFFFFF
FFFFFFFFFFFFFFFFFFFFFFFFFFFFF
FFFFFFFFFFFFFFFF77FFFFFFFFFFF
FFFFFFFFFFFEFFFFFEFFFFFFFFFFF
FFFFFFFFFFFE77FF76FFFFFFFFFFF
FFFFFFFFFFFFFEFEFFFFFFFFFFFFF
FFFFFFFFFFFFFEFE77FFFFFFFFFFF
FFFFFFFFFFFFFFFFFFFFFFFFFFFFF
FFFFFFFFFFFFFFFFFFFFFFFFFFFFF

19, 9
19, 5